000000000000000000022200000000000000000000000000000000000000
000001111111100000011100000000000000000000000000000000000000
000011111111111111111100000000000000000000000000000000000000
000011110011111111111100000000000000000000000000000000000000
000111100000000000000000000000000000000000000000000000000000
000111000011111100000000000000000000000000000000000000000000
000111000111111110000000000000000000000000000000000000000000
000111001111111111000000000000000000000000000000000000000000
000111011110001111000000000000000000000000000000000000000000
000111111110000111000000000000000000000000000000000000000000
000011111100000111100000000000000000000000000000000000000000
000001110000000111110000000000000000000000000000011111111112
000000000000000011110000000000000000000000000001111111111112
000000000000000011110000000000000000000000000011111111111112
000000000000000011110000000000000002200000000011111000000000
000000000000000011110000000000000001100000000011110000000000
000000000000000111100000000000000001100000000011100000000000
000000000000000111100000000000000011110000000011100000000000
000000000000001111000000000000000111100000000011100000000000
000000000000001110000000000111111111001111111111100000000000
000000000000001110000000111111111110011111111111100000000000
211111111111111110011111111111111111111111111111100000000000
211111111111111111111111111111001111111110000000000000000000
211111111111111111111111111000000111111100000000000000000000
000000000000001111111000000000000000111000000000000000000000
000000000000000001111000000000000000111000000000000000000000
000000000000000001111100000000000000111000000000000000000000
000000000000000000111100000000000000111111112000000000000000
000000000000000000111100000000000000111111112000000000000000
000000000000111111111100000000000000111111112000000000000000
000000000011111111111100000000000000111000000000000000000000
000000000111111111111000000000000000111000000000000000000000
000000001111110000000000000000000000111000000000000000000000
000000002220000000000000000000000000222000000000000000000000
