000000000000000000000000000000000000000000000000000000000000
000000000000000000000000000000111110011100000000000011111100
000000000000000000000000000000111000011100000000000011111100
000000000000000000000000000000111000011100000000000011001100
000000000000000000000000000000111000111100000000000011001100
000000000000000000000000000000111111111110000001011111001100
000000000000000000000000000000111011111110000011221001111100
000000000000000000000000000000111001111110000011221001111100
000000000000000000000000000000111100111111111111111111111110
000000000000000000000000000000111110011111111111111111111110
211111100000000000000000001111111111011111111111111111111110
211111110000000000011110000001111111021111111111111111111112
211111111000000000111110000001111111021111111111111111111112
000011111100000011111112200001111111021111111111111111111112
000000111110000011111110000001111111011111111111111111111110
000000011111111111110000000001111110011111111111000001111110
000000011111111111100000000000111100011000000111000001111110
000000001111111111100000000000111000011000000111000001111110
000000000000000000000000000000110001111000000111000001111110
000000000000000000000000000000110001111000000111000001111110
000000000000000000000000000000110011111000000111111111111110
000000000000000000000000000000110111111000000111100001111100
000000000000000000000000000000110111111000000010000000111100
000000000000000000000000000000111111111111111110000000111100
000000000000000000000000000000110011111111111110000000111100
000000000000000000000000000000110111111000001110000000111100
000000000000000000000000000000110111111000001110000000111100
000000000000000000000000000001110111111000001111000000111100
000000000000000000000000000011110111111000001111000000111110
000000000000000000000000000011110011111000001001111111111110
000000000000000000000000000011111001111111111001221111111110
000000000000000000000000000001111100111111111001221111111110
000000000000000000000000000000111110011111111111111111111110
000000000000000000000000000000000000000000000000000000000000
